....................
................X...
...--..........--...
......--............
...--..........--...
............--......
...--..........--...
....................
...--..........--...
.1..................
####################
