..........X.........
.......######.......
....................
####.............###
....................
......--------......
....................
####............####
....................
.1..................
####################
