...GG...............
...GG...............
...GG...............
..####..............
....................
......#.............
.......#............
.........GGG........
.........###........
....................
....GGG.......GGG...
....###.......###...
....................
.1................X.
####################
