....................
....................
....................
....................
.........###........
....................
....#..........#....
...####.......###...
....................
.1...............X..
####################